#Catalan multiwords file used for chunking
A base d'	LOC_PREP
A base de	LOC_PREP
A bé d'	LOC_PREP
A bé de	LOC_PREP
A canvi d'	LOC_PREP
A canvi de	LOC_PREP
A casa d'	LOC_PREP
A casa de	LOC_PREP
A causa d'	LOC_PREP
A causa de	LOC_PREP
A cavall d'	LOC_PREP
A cavall de	LOC_PREP
A cient d'	LOC_PREP
A cient de	LOC_PREP
A cobert d'	LOC_PREP
A cobert de	LOC_PREP
A coneguda d'	LOC_PREP
A coneguda de	LOC_PREP
A coneixença d'	LOC_PREP
A coneixença de	LOC_PREP
A conseqüència d'	LOC_PREP
A conseqüència de	LOC_PREP
A cop d'	LOC_PREP
A cop de	LOC_PREP
A costa d'	LOC_PREP
A costa de	LOC_PREP
A càrrec d'	LOC_PREP
A càrrec de	LOC_PREP
A còpia d'	LOC_PREP
A còpia de	LOC_PREP
A desgrat d'	LOC_PREP
A desgrat de	LOC_PREP
A despit d'	LOC_PREP
A despit de	LOC_PREP
A dies	LOC_ADV
A diferència d'	LOC_PREP
A diferència de	LOC_PREP
A excepció d'	LOC_PREP
A excepció de	LOC_PREP
A falta d'	LOC_PREP
A falta de	LOC_PREP
A força d'	LOC_PREP
A força de	LOC_PREP
A guisa d'	LOC_PREP
A guisa de	LOC_PREP
A l caient d'	LOC_PREP
A l caient de	LOC_PREP
A l cap d'	LOC_PREP
A l cap de	LOC_PREP
A l capdamunt d'	LOC_PREP
A l capdamunt de	LOC_PREP
A l capdavall	LOC_ADV
A l capdavall d'	LOC_PREP
A l capdavall de	LOC_PREP
A l capdavant	LOC_ADV
A l capdavant d'	LOC_PREP
A l capdavant de	LOC_PREP
A l cim d'	LOC_PREP
A l cim de	LOC_PREP
A l contrari d'	LOC_PREP
A l contrari de	LOC_PREP
A l costat d'	LOC_PREP
A l costat de	LOC_PREP
A l dedins d'	LOC_PREP
A l dedins de	LOC_PREP
A l defora d'	LOC_PREP
A l defora de	LOC_PREP
A l dellà d'	LOC_PREP
A l dellà de	LOC_PREP
A l final	LOC_ADV
A l llarg d'	LOC_PREP
A l llarg de	LOC_PREP
A l manar d'	LOC_PREP
A l manar de	LOC_PREP
A l menys	LOC_ADV
A l meu torn	LOC_ADV
A l preu d'	LOC_PREP
A l preu de	LOC_PREP
A l revés d'	LOC_PREP
A l revés de	LOC_PREP
A l seu torn	LOC_ADV
A l seu voltant	LOC_ADV
A l teu torn	LOC_ADV
A l tombant d'	LOC_PREP
A l tombant de	LOC_PREP
A l voltant d'	LOC_PREP
A l voltant de	LOC_PREP
A l' instant	LOC_ADV
A l'abast d'	LOC_PREP
A l'abast de	LOC_PREP
A l'abric d'	LOC_PREP
A l'abric de	LOC_PREP
A l'atenció d'	LOC_PREP
A l'atenció de	LOC_PREP
A l'empara d'	LOC_PREP
A l'empara de	LOC_PREP
A l'entrant d'	LOC_PREP
A l'entrant de	LOC_PREP
A la claror d'	LOC_PREP
A la claror de	LOC_PREP
A la fi	LOC_ADV
A la mercè d'	LOC_PREP
A la mercè de	LOC_PREP
A la recerca d'	LOC_PREP
A la recerca de	LOC_PREP
A la vegada	LOC_ADV
A la vora d'	LOC_PREP
A la vora de	LOC_PREP
A les envistes d'	LOC_PREP
A les envistes de	LOC_PREP
A manera d'	LOC_PREP
A manera de	LOC_PREP
A mercè d'	LOC_PREP
A mercè de	LOC_PREP
A mesura que	LOC_CONJ
A mitjan	LOC_PREP
A més	LOC_ADV
A més a més	LOC_ADV
A part	LOC_ADV
A part d'	LOC_PREP
A part de	LOC_PREP
A penes	LOC_ADV
A pesar d'	LOC_PREP
A pesar de	LOC_PREP
A petició d'	LOC_PREP
A petició de	LOC_PREP
A poc a poc	LOC_ADV
A precs d'	LOC_PREP
A precs de	LOC_PREP
A preu de 	LOC_PREP
A prova d'	LOC_PREP
A prova de	LOC_PREP
A recules	LOC_ADV
A reculons	LOC_ADV
A requesta d'	LOC_PREP
A requesta de	LOC_PREP
A reserva d'	LOC_PREP
A reserva de	LOC_PREP
A semblança d'	LOC_PREP
A semblança de	LOC_PREP
A tota hora	LOC_ADV
A través d'	LOC_PREP
A través de	LOC_PREP
A trossos	LOC_ADV
A ulls clucs	LOC_ADV
A vegades	LOC_ADV
A vessar	LOC_ADV
A voltes	LOC_ADV
A voluntat	LOC_ADV
A última hora	LOC_ADV
Abans d'	LOC_PREP
Abans de	LOC_PREP
Acabat d'	LOC_PREP
Acabat de	LOC_PREP
Així mateix	LOC_CONJ
Això no obstant	LOC_ADV
Al capdavall	LOC_ADV
Al capdavant	LOC_ADV
Al final	LOC_ADV
Al menys	LOC_ADV
Al més	LOC_ADV
Allèn d'	LOC_PREP
Allèn de	LOC_PREP
Amb caràcter d'	LOC_PREP
Amb caràcter de	LOC_PREP
Amb freqüència	LOC_ADV
Amb referència a	LOC_PREP
Amb tot i	LOC_PREP
Ara com ara	LOC_ADV
Ara mateix	LOC_ADV
Ara per ara	LOC_ADV
Arran d'	LOC_PREP
Arran de	LOC_PREP
Arreu d'	LOC_PREP
Arreu de	LOC_PREP
Atenent que	LOC_CONJ
Atès que	LOC_CONJ
Avinent d'	LOC_PREP
Avinent de	LOC_PREP
Avui dia	LOC_ADV
Avui en dia	LOC_ADV
Bel canto	NCMS000
Ben bé	LOC_ADV
Bona cosa	LOC_ADV
Bé prou	LOC_ADV
Camp a través	LOC_ADV
Cara a cara	LOC_ADV
Com a	LOC_PREP
Com ara	LOC_CONJ
Cos a cos	LOC_ADV
Cos per cos	LOC_ADV
D' acord amb	LOC_PREP
D' alguna manera	LOC_ADV
D' allò més	LOC_ADV
D' altra banda	LOC_CONJ
D' amagat	LOC_ADV
D' amagat d'	LOC_PREP
D' amagat de	LOC_PREP
D' antuvi	LOC_ADV
D' aquí a	LOC_PREP
D' ençà d'	LOC_PREP
D' ençà de	LOC_PREP
D' esbiaixada	LOC_PREP
D' esma	LOC_ADV
D' esquerres	LOC_ADV
D' esquitllada	LOC_ADV
D' esquitllentes	LOC_ADV
D' estar per casa	LOC_ADV
D' estira i arronsa	LOC_ADV
D' estranquis	LOC_ADV
D' estrena	LOC_ADV
D' etiqueta	LOC_ADV
D' hora	LOC_ADV
D' imitació	LOC_ADV
D' improvís	LOC_ADV
D' inicògnit	LOC_ADV
D' un a un	LOC_ADV
D' un cap a l' altre	LOC_ADV
D' un costat a l' altre	LOC_ADV
D' un dia a l' altre	LOC_ADV
D' un en un	LOC_ADV
D' un plegat	LOC_ADV
D' una a una	LOC_ADV
D' una en una	LOC_ADV
D' una vegada	LOC_ADV
D' upa	LOC_ADV
D' última hora	LOC_ADV
Da capo	LOC_ADV
Damunt dit	LOC_ADV
De bell antuvi	LOC_ADV
De bell nou	LOC_ADV
De bell principi	LOC_ADV
De biaix	LOC_ADV
De bocaterrosa	LOC_ADV
De bona font	LOC_ADV
De bona gana	LOC_ADV
De cara a	LOC_PREP
De debò	LOC_ADV
De dretes	LOC_ADV
De gom a gom	LOC_ADV
De iure	LOC_ADV
De l tot	LOC_ADV
De manera que	LOC_CONJ
De mentida	LOC_ADJ
De mitjan	LOC_PREP
De moda	LOC_ADJ
De més a més	LOC_ADV
De nou	LOC_ADV
De por d'	LOC_PREP
De por de	LOC_PREP
De pressa	LOC_ADV
De seguida	LOC_ADV
De segur	LOC_ADV
De sobte	LOC_ADV
De soca-rel	LOC_ADV
De sol a sol	LOC_ADV
De sorpresa	LOC_ADV
De sotamà	LOC_ADV
De tal manera	LOC_ADV
De tal manera que	LOC_CONJ
De tant en tant	LOC_ADV
De tard en tard	LOC_ADV
De tomballons	LOC_ADV
De tort	LOC_ADV
De tot cor	LOC_ADV
De tot en tota	LOC_ADV
De través	LOC_ADV
De vegades	LOC_ADV
De veres	LOC_ADV
De veritat	LOC_ADV
De via estreta	LOC_ADV
De viu en viu	LOC_ADV
De viva veu	LOC_ADV
Del tot	LOC_ADV
Deçà i dellà d'	LOC_PREP
Deçà i dellà de	LOC_PREP
Dia i nit	LOC_ADV
Dia sí dia no	LOC_ADV
Donat que	LOC_CONJ
Déu n' hi do	LOC_ADV
En absolut	LOC_ADV
En absència d'	LOC_PREP
En absència de	LOC_PREP
En acabat	LOC_ADV
En acabat d'	LOC_PREP
En acabat de	LOC_PREP
En actiu	LOC_ADV
En aigües d'	LOC_PREP
En aigües de	LOC_PREP
En ales d'	LOC_PREP
En ales de	LOC_PREP
En alt grau	LOC_ADV
En altre temps	LOC_ADV
En amunt	LOC_ADV
En avall	LOC_ADV
En benefici d'	LOC_PREP
En benefici de	LOC_PREP
En blanc	LOC_ADV
En bona fe	LOC_ADV
En bona hora	LOC_ADV
En bona part	LOC_ADV
En breu	LOC_ADV
En brut	LOC_ADV
En bé d'	LOC_PREP
En bé de	LOC_PREP
En cadena	LOC_ADV
En canvi d'	LOC_PREP
En canvi de	LOC_PREP
En cerca d'	LOC_PREP
En cerca de	LOC_PREP
En certa manera	LOC_ADV
En compte d'	LOC_PREP
En compte de	LOC_PREP
En comptes d'	LOC_PREP
En comptes de	LOC_PREP
En comú	LOC_ADV
En confrontació amb	LOC_PREP
En conill	LOC_ADV
En consonància amb	LOC_PREP
En contemplació d'	LOC_PREP
En contemplació de	LOC_PREP
En contra	LOC_ADV
En contra d'	LOC_PREP
En contra de	LOC_PREP
En creu	LOC_ADV
En curs d'	LOC_PREP
En curs de	LOC_PREP
En dejú	LOC_ADV
En detall	LOC_ADV
En doina	LOC_ADV
En efecte	LOC_ADV
En efectiu	LOC_ADV
En especial	LOC_ADV
En exclusiva	LOC_ADV
En fals	LOC_ADV
En ferm	LOC_ADV
En fet d'	LOC_PREP
En fet de	LOC_PREP
En fi	LOC_ADV
En fresc	LOC_ADV
En funció d'	LOC_PREP
En funció de	LOC_PREP
En general	LOC_ADV
En gran part	LOC_ADV
En la mesura en què	LOC_CONJ
En la mesura que	LOC_CONJ
En la seua majoria	LOC_ADV
En la seva majoria	LOC_ADV
En matèria d'	LOC_PREP
En matèria de	LOC_PREP
En mig d'	LOC_PREP
En mig de	LOC_PREP
En nom d'	LOC_PREP
En nom de	LOC_PREP
En ocasió d'	LOC_PREP
En ocasió de	LOC_PREP
En part	LOC_ADV
En particular	LOC_ADV
En principi	LOC_ADV
En pro d'	LOC_PREP
En pro de	LOC_PREP
En realitat	LOC_ADV
En relació amb	LOC_PREP
En secret	LOC_ADV
En senya l d'	LOC_PREP
En senya l de	LOC_PREP
En temps en temps	LOC_ADV
En virtut d'	LOC_PREP
En virtut de	LOC_PREP
En vist	LOC_PREP
En vistes d'	LOC_PREP
En vistes de	LOC_PREP
Enfront d'	LOC_PREP
Enfront d' 	LOC_ADV
Enfront de	LOC_ADV
Enfront de	LOC_PREP
Enfront del	LOC_ADV
Enfront dels	LOC_ADV
Enmig d'	LOC_PREP
Enmig de	LOC_PREP
Entorn d'	LOC_PREP
Entorn de	LOC_PREP
Estats Units	NPMPG00
Fa molt poc	LOC_ADV
Fa poc	LOC_ADV
Fet i fet	LOC_ADV
Fins a l punt d'	LOC_PREP
Fins a l punt de	LOC_PREP
Fins a mitjan	LOC_PREP
Fins ara	LOC_ADV
Fins avui	LOC_ADV
Fins i tot	LOC_ADV
Front a front	LOC_ADV
Futbol sala	NCMS000
Gens ni mica	LOC_ADV
Gran Bretanya	NPFSG00
Gràcies a	LOC_PREP
Honoris causa	LOC_ADV
Junt amb	LOC_PREP
Juntament amb	LOC_PREP
Llevat d'	LOC_PREP
Llevat de	LOC_PREP
Lluny d'	LOC_PREP
Lluny de	LOC_PREP
Manta vegada	LOC_ADV
Millor dit	LOC_ADV
Molt i molt	LOC_ADV
Mutatis mutandis	LOC_ADV
Més ben dit	LOC_ADV
Més i més	LOC_ADV
Més o menys	LOC_ADV
No fa gaire	LOC_ADV
No gaire	LOC_ADV
No gens	LOC_ADV
No obstant	LOC_PREP
No obstant això	LOC_ADV
Oi més	LOC_ADV
Pe l cap alt	LOC_ADV
Pe l cap baix	LOC_ADV
Pel cap alt	LOC_ADV
Pel cap baix	LOC_ADV
Pel que es refereix a	LOC_PREP
Pel que fa a	LOC_PREP
Pels volts d'	LOC_PREP
Pels volts de	LOC_PREP
Per causa d'	LOC_PREP
Per causa de	LOC_PREP
Per comparació a	LOC_PREP
Per contemplació d'	LOC_PREP
Per contemplació de	LOC_PREP
Per damunt de tot	LOC_ADV
Per exemple	LOC_ADV
Per mitjà d'	LOC_PREP
Per mitjà de	LOC_PREP
Per mor d'	LOC_PREP
Per mor de	LOC_PREP
Per motius d'	LOC_PREP
Per motius de	LOC_PREP
Per obra i gràcia d'	LOC_PREP
Per obra i gràcia de	LOC_PREP
Per oposició a	LOC_PREP
Per por d'	LOC_PREP
Per por de	LOC_PREP
Per se	LOC_ADV
Per sobre de tot	LOC_ADV
Per tal d'	LOC_PREP
Per tal de	LOC_PREP
Per virtut d'	LOC_PREP
Per virtut de	LOC_PREP
Quant i més	LOC_PREP
Quant més	LOC_PREP
Qui-sap-lo	LOC_ADV
Referent a	LOC_PREP
Relativament a	LOC_PREP
Respecte a	LOC_PREP
Respecte d'	LOC_PREP
Respecte de	LOC_PREP
Segons que	LOC_CONJ
Seguit seguit	LOC_ADV
Sense perjudici d'	LOC_PREP
Sense perjudici de	LOC_PREP
Si fa no fa	LOC_ADV
Si més no	LOC_ADV
Sota capa d'	LOC_PREP
Sota capa de	LOC_PREP
Tan solament	LOC_ADV
Tan sols	LOC_ADV
Tant menys	LOC_ADV
Tant més	LOC_ADV
Tocant a	LOC_PREP
Tot d' una	LOC_ADV
Tot just	LOC_ADV
Tot plegat	LOC_ADV
Tot seguit	LOC_ADV
Tot sol	LOC_ADV
Tota sola	LOC_ADV
Totes soles	LOC_ADV
Tots sols	LOC_ADV
Tour de force	NCMS000
Ultra mesura	LOC_ADV
Un per un	LOC_ADV
Un poc	LOC_ADV
Un pèl	LOC_ADV
Un xic	LOC_ADV
Una mica	LOC_ADV
Una per una	LOC_ADV
Vist i no vist	LOC_ADV
a base d'	LOC_PREP
a base de	LOC_PREP
a bé d'	LOC_PREP
a bé de	LOC_PREP
a canvi d'	LOC_PREP
a canvi de	LOC_PREP
a casa d'	LOC_PREP
a casa de	LOC_PREP
a causa d'	LOC_PREP
a causa de	LOC_PREP
a cavall d'	LOC_PREP
a cavall de	LOC_PREP
a cient d'	LOC_PREP
a cient de	LOC_PREP
a cobert d'	LOC_PREP
a cobert de	LOC_PREP
a coneguda d'	LOC_PREP
a coneguda de	LOC_PREP
a coneixença d'	LOC_PREP
a coneixença de	LOC_PREP
a conseqüència d'	LOC_PREP
a conseqüència de	LOC_PREP
a cop d'	LOC_PREP
a cop de	LOC_PREP
a costa d'	LOC_PREP
a costa de	LOC_PREP
a càrrec d'	LOC_PREP
a càrrec de	LOC_PREP
a còpia d'	LOC_PREP
a còpia de	LOC_PREP
a desgrat d'	LOC_PREP
a desgrat de	LOC_PREP
a despit d'	LOC_PREP
a despit de	LOC_PREP
a dies	LOC_ADV
a diferència d'	LOC_PREP
a diferència de	LOC_PREP
a excepció d'	LOC_PREP
a excepció de	LOC_PREP
a falta d'	LOC_PREP
a falta de	LOC_PREP
a força d'	LOC_PREP
a força de	LOC_PREP
a guisa d'	LOC_PREP
a guisa de	LOC_PREP
a l caient d'	LOC_PREP
a l caient de	LOC_PREP
a l cap d'	LOC_PREP
a l cap de	LOC_PREP
a l capdamunt d'	LOC_PREP
a l capdamunt de	LOC_PREP
a l capdavall	LOC_ADV
a l capdavall d'	LOC_PREP
a l capdavall de	LOC_PREP
a l capdavant	LOC_ADV
a l capdavant d'	LOC_PREP
a l capdavant de	LOC_PREP
a l cim d'	LOC_PREP
a l cim de	LOC_PREP
a l contrari d'	LOC_PREP
a l contrari de	LOC_PREP
a l costat d'	LOC_PREP
a l costat de	LOC_PREP
a l dedins d'	LOC_PREP
a l dedins de	LOC_PREP
a l defora d'	LOC_PREP
a l defora de	LOC_PREP
a l dellà d'	LOC_PREP
a l dellà de	LOC_PREP
a l final	LOC_ADV
a l llarg d'	LOC_PREP
a l llarg de	LOC_PREP
a l manar d'	LOC_PREP
a l manar de	LOC_PREP
a l menys	LOC_ADV
a l meu torn	LOC_ADV
a l preu d'	LOC_PREP
a l preu de	LOC_PREP
a l revés d'	LOC_PREP
a l revés de	LOC_PREP
a l seu torn	LOC_ADV
a l seu voltant	LOC_ADV
a l teu torn	LOC_ADV
a l tombant d'	LOC_PREP
a l tombant de	LOC_PREP
a l voltant d'	LOC_PREP
a l voltant de	LOC_PREP
a l' instant	LOC_ADV
a l'abast d'	LOC_PREP
a l'abast de	LOC_PREP
a l'abric d'	LOC_PREP
a l'abric de	LOC_PREP
a l'atenció d'	LOC_PREP
a l'atenció de	LOC_PREP
a l'empara d'	LOC_PREP
a l'empara de	LOC_PREP
a l'entrant d'	LOC_PREP
a l'entrant de	LOC_PREP
a la claror d'	LOC_PREP
a la claror de	LOC_PREP
a la fi	LOC_ADV
a la mercè d'	LOC_PREP
a la mercè de	LOC_PREP
a la recerca d'	LOC_PREP
a la recerca de	LOC_PREP
a la vegada	LOC_ADV
a la vora d'	LOC_PREP
a la vora de	LOC_PREP
a les envistes d'	LOC_PREP
a les envistes de	LOC_PREP
a manera d'	LOC_PREP
a manera de	LOC_PREP
a mercè d'	LOC_PREP
a mercè de	LOC_PREP
a mesura que	LOC_CONJ
a mitjan	LOC_PREP
a més	LOC_ADV
a més a més	LOC_ADV
a part	LOC_ADV
a part d'	LOC_PREP
a part de	LOC_PREP
a penes	LOC_ADV
a pesar d'	LOC_PREP
a pesar de	LOC_PREP
a petició d'	LOC_PREP
a petició de	LOC_PREP
a poc a poc	LOC_ADV
a precs d'	LOC_PREP
a precs de	LOC_PREP
a preu de 	LOC_PREP
a prova d'	LOC_PREP
a prova de	LOC_PREP
a recules	LOC_ADV
a reculons	LOC_ADV
a requesta d'	LOC_PREP
a requesta de	LOC_PREP
a reserva d'	LOC_PREP
a reserva de	LOC_PREP
a semblança d'	LOC_PREP
a semblança de	LOC_PREP
a tota hora	LOC_ADV
a través d'	LOC_PREP
a través de	LOC_PREP
a trossos	LOC_ADV
a ulls clucs	LOC_ADV
a vegades	LOC_ADV
a vessar	LOC_ADV
a voltes	LOC_ADV
a voluntat	LOC_ADV
a última hora	LOC_ADV
abans d'	LOC_PREP
abans de	LOC_PREP
acabat d'	LOC_PREP
acabat de	LOC_PREP
així mateix	LOC_CONJ
això no obstant	LOC_ADV
al capdavall	LOC_ADV
al capdavant	LOC_ADV
al final	LOC_ADV
al menys	LOC_ADV
al més	LOC_ADV
allèn d'	LOC_PREP
allèn de	LOC_PREP
amb caràcter d'	LOC_PREP
amb caràcter de	LOC_PREP
amb freqüència	LOC_ADV
amb referència a	LOC_PREP
amb tot i	LOC_PREP
ara com ara	LOC_ADV
ara mateix	LOC_ADV
ara per ara	LOC_ADV
arran d'	LOC_PREP
arran de	LOC_PREP
arreu d'	LOC_PREP
arreu de	LOC_PREP
atenent que	LOC_CONJ
atès que	LOC_CONJ
avinent d'	LOC_PREP
avinent de	LOC_PREP
avui dia	LOC_ADV
avui en dia	LOC_ADV
bel canto	NCMS000
ben bé	LOC_ADV
bona cosa	LOC_ADV
bé prou	LOC_ADV
camp a través	LOC_ADV
cara a cara	LOC_ADV
com a	LOC_PREP
com ara	LOC_CONJ
cos a cos	LOC_ADV
cos per cos	LOC_ADV
d' acord amb	LOC_PREP
d' alguna manera	LOC_ADV
d' allò més	LOC_ADV
d' altra banda	LOC_CONJ
d' amagat	LOC_ADV
d' amagat d'	LOC_PREP
d' amagat de	LOC_PREP
d' antuvi	LOC_ADV
d' aquí a	LOC_PREP
d' ençà d'	LOC_PREP
d' ençà de	LOC_PREP
d' esbiaixada	LOC_PREP
d' esma	LOC_ADV
d' esquerres	LOC_ADV
d' esquitllada	LOC_ADV
d' esquitllentes	LOC_ADV
d' estar per casa	LOC_ADV
d' estira i arronsa	LOC_ADV
d' estranquis	LOC_ADV
d' estrena	LOC_ADV
d' etiqueta	LOC_ADV
d' hora	LOC_ADV
d' imitació	LOC_ADV
d' improvís	LOC_ADV
d' inicògnit	LOC_ADV
d' un a un	LOC_ADV
d' un cap a l' altre	LOC_ADV
d' un costat a l' altre	LOC_ADV
d' un dia a l' altre	LOC_ADV
d' un en un	LOC_ADV
d' un plegat	LOC_ADV
d' una a una	LOC_ADV
d' una en una	LOC_ADV
d' una vegada	LOC_ADV
d' upa	LOC_ADV
d' última hora	LOC_ADV
da capo	LOC_ADV
damunt dit	LOC_ADV
de bell antuvi	LOC_ADV
de bell nou	LOC_ADV
de bell principi	LOC_ADV
de biaix	LOC_ADV
de bocaterrosa	LOC_ADV
de bona font	LOC_ADV
de bona gana	LOC_ADV
de cara a	LOC_PREP
de debò	LOC_ADV
de dretes	LOC_ADV
de fiar	LOC_ADJ
de gom a gom	LOC_ADV
de iure	LOC_ADV
de l tot	LOC_ADV
de manera que	LOC_CONJ
de manual	LOC_ADJ
de mentida	LOC_ADJ
de mitjan	LOC_PREP
de moda	LOC_ADJ
de més a més	LOC_ADV
de nou	LOC_ADV
de por d'	LOC_PREP
de por de	LOC_PREP
de pressa	LOC_ADV
de seguida	LOC_ADV
de segur	LOC_ADV
de sobte	LOC_ADV
de soca-rel	LOC_ADV
de sol a sol	LOC_ADV
de sorpresa	LOC_ADV
de sotamà	LOC_ADV
de tal manera	LOC_ADV
de tal manera que	LOC_CONJ
de tant en tant	LOC_ADV
de tard en tard	LOC_ADV
de tomballons	LOC_ADV
de tort	LOC_ADV
de tot cor	LOC_ADV
de tot en tota	LOC_ADV
de través	LOC_ADV
de vegades	LOC_ADV
de veres	LOC_ADV
de veritat	LOC_ADV
de via estreta	LOC_ADV
de viu en viu	LOC_ADV
de viva veu	LOC_ADV
del tot	LOC_ADV
deçà i dellà d'	LOC_PREP
deçà i dellà de	LOC_PREP
dia i nit	LOC_ADV
dia sí dia no	LOC_ADV
donat que	LOC_CONJ
en absolut	LOC_ADV
en absència d'	LOC_PREP
en absència de	LOC_PREP
en acabat	LOC_ADV
en acabat d'	LOC_PREP
en acabat de	LOC_PREP
en actiu	LOC_ADV
en aigües d'	LOC_PREP
en aigües de	LOC_PREP
en ales d'	LOC_PREP
en ales de	LOC_PREP
en alt grau	LOC_ADV
en altre temps	LOC_ADV
en amunt	LOC_ADV
en avall	LOC_ADV
en benefici d'	LOC_PREP
en benefici de	LOC_PREP
en blanc	LOC_ADV
en bona fe	LOC_ADV
en bona hora	LOC_ADV
en bona part	LOC_ADV
en breu	LOC_ADV
en brut	LOC_ADV
en bé d'	LOC_PREP
en bé de	LOC_PREP
en cadena	LOC_ADV
en canvi d'	LOC_PREP
en canvi de	LOC_PREP
en cerca d'	LOC_PREP
en cerca de	LOC_PREP
en certa manera	LOC_ADV
en compte d'	LOC_PREP
en compte de	LOC_PREP
en comptes d'	LOC_PREP
en comptes de	LOC_PREP
en comú	LOC_ADV
en confrontació amb	LOC_PREP
en conill	LOC_ADV
en consonància amb	LOC_PREP
en contemplació d'	LOC_PREP
en contemplació de	LOC_PREP
en contra	LOC_ADV
en contra d'	LOC_PREP
en contra de	LOC_PREP
en creu	LOC_ADV
en curs d'	LOC_PREP
en curs de	LOC_PREP
en dejú	LOC_ADV
en detall	LOC_ADV
en doina	LOC_ADV
en efecte	LOC_ADV
en efectiu	LOC_ADV
en especial	LOC_ADV
en exclusiva	LOC_ADV
en fals	LOC_ADV
en ferm	LOC_ADV
en fet d'	LOC_PREP
en fet de	LOC_PREP
en fi	LOC_ADV
en fresc	LOC_ADV
en funció d'	LOC_PREP
en funció de	LOC_PREP
en general	LOC_ADV
en gran part	LOC_ADV
en la mesura en què	LOC_CONJ
en la mesura que	LOC_CONJ
en la seua majoria	LOC_ADV
en la seva majoria	LOC_ADV
en matèria d'	LOC_PREP
en matèria de	LOC_PREP
en mig d'	LOC_PREP
en mig de	LOC_PREP
en nom d'	LOC_PREP
en nom de	LOC_PREP
en ocasió d'	LOC_PREP
en ocasió de	LOC_PREP
en part	LOC_ADV
en particular	LOC_ADV
en principi	LOC_ADV
en pro d'	LOC_PREP
en pro de	LOC_PREP
en realitat	LOC_ADV
en relació amb	LOC_PREP
en secret	LOC_ADV
en senya l d'	LOC_PREP
en senya l de	LOC_PREP
en temps en temps	LOC_ADV
en virtut d'	LOC_PREP
en virtut de	LOC_PREP
en vist	LOC_PREP
en vistes d'	LOC_PREP
en vistes de	LOC_PREP
enfront d'	LOC_PREP
enfront d' 	LOC_ADV
enfront de	LOC_ADV
enfront de	LOC_PREP
enfront del	LOC_ADV
enfront dels	LOC_ADV
enmig d'	LOC_PREP
enmig de	LOC_PREP
entorn d'	LOC_PREP
entorn de	LOC_PREP
ex aequo	LOC_ADV
ex cathedra	LOC_ADV
fa molt poc	LOC_ADV
fa poc	LOC_ADV
fet i fet	LOC_ADV
fins a l punt d'	LOC_PREP
fins a l punt de	LOC_PREP
fins a mitjan	LOC_PREP
fins ara	LOC_ADV
fins avui	LOC_ADV
fins i tot	LOC_ADV
front a front	LOC_ADV
futbol sala	NCMS000
gens ni mica	LOC_ADV
gràcies a	LOC_PREP
hagudes i per haver	AQ0FP0
haguts i per haver	AQ0MP0
honoris causa	LOC_ADV
junt amb	LOC_PREP
juntament amb	LOC_PREP
llevat d'	LOC_PREP
llevat de	LOC_PREP
lluny d'	LOC_PREP
lluny de	LOC_PREP
manta vegada	LOC_ADV
millor dit	LOC_ADV
molt i molt	LOC_ADV
mutatis mutandis	LOC_ADV
més ben dit	LOC_ADV
més i més	LOC_ADV
més o menys	LOC_ADV
no fa gaire	LOC_ADV
no gaire	LOC_ADV
no gens	LOC_ADV
no obstant	LOC_PREP
no obstant això	LOC_ADV
oi més	LOC_ADV
pe l cap alt	LOC_ADV
pe l cap baix	LOC_ADV
pel cap alt	LOC_ADV
pel cap baix	LOC_ADV
pel que es refereix a	LOC_PREP
pel que fa a	LOC_PREP
pels volts d'	LOC_PREP
pels volts de	LOC_PREP
per causa d'	LOC_PREP
per causa de	LOC_PREP
per comparació a	LOC_PREP
per contemplació d'	LOC_PREP
per contemplació de	LOC_PREP
per damunt de tot	LOC_ADV
per exemple	LOC_ADV
per mitjà d'	LOC_PREP
per mitjà de	LOC_PREP
per mor d'	LOC_PREP
per mor de	LOC_PREP
per motius d'	LOC_PREP
per motius de	LOC_PREP
per obra i gràcia d'	LOC_PREP
per obra i gràcia de	LOC_PREP
per oposició a	LOC_PREP
per por d'	LOC_PREP
per por de	LOC_PREP
per se	LOC_ADV
per sobre de tot	LOC_ADV
per tal d'	LOC_PREP
per tal de	LOC_PREP
per virtut d'	LOC_PREP
per virtut de	LOC_PREP
quant i més	LOC_PREP
quant més	LOC_PREP
qui-sap-lo	LOC_ADV
referent a	LOC_PREP
relativament a	LOC_PREP
respecte a	LOC_PREP
respecte d'	LOC_PREP
respecte de	LOC_PREP
segons que	LOC_CONJ
seguit seguit	LOC_ADV
sense perjudici d'	LOC_PREP
sense perjudici de	LOC_PREP
si fa no fa	LOC_ADV
si més no	LOC_ADV
sota capa d'	LOC_PREP
sota capa de	LOC_PREP
tan solament	LOC_ADV
tan sols	LOC_ADV
tant menys	LOC_ADV
tant més	LOC_ADV
tocant a	LOC_PREP
tot d' una	LOC_ADV
tot just	LOC_ADV
tot plegat	LOC_ADV
tot seguit	LOC_ADV
tot sol	LOC_ADV
tota sola	LOC_ADV
totes soles	LOC_ADV
tots sols	LOC_ADV
tour de force	NCMS000
ultra mesura	LOC_ADV
un per un	LOC_ADV
un poc	LOC_ADV
un pèl	LOC_ADV
un xic	LOC_ADV
una mica	LOC_ADV
una per una	LOC_ADV
vist i no vist	LOC_ADV

